11111111111111111
80200000200000001
10303010303011101
10202010202011001
10003000003000021
11111321111323911
#
1 2