111181
100001
102321
100001
132301
300001
201101
301101
900101
120001
111111
#
25 0